50
##################################################
#.....................#..........................#
#.....................#..........................#
#.....................#..........................#
#.....................#..........................#
#.....................#..........................#
#................................................#
#................................................#
#................................................#
#................................................#
#................................................#
#.....................#..........................#
#.....................#..........................#
#.....................#..........................#
#.....................#..........................#
#.....................#..........................#
#.....................#..........................#
#.....................#..........................#
#.....................#..........................#
#.....................#..........................#
#.....................#..........................#
#.....................#..........................#
############...######################...##########
#.....................#..........................#
#.....................#..........................#
#.....................#..........................#
#.....................#..........................#
#.....................#..........................#
#.....................#..........................#
#.....................#..........................#
#.....................#..........................#
#.....................#..........................#
#.....................#..........................#
#.....................#..........................#
#.....................#..........................#
#................................................#
#................................................#
#................................................#
#................................................#
#................................................#
#................................................#
#................................................#
#................................................#
#.....................#..........................#
#.....................#..........................#
#.....................#..........................#
#.....................#..........................#
#.....................#..........................#
#.....................#..........................#
##################################################