50
############################################################
#.....................#....................................#
#.....................#....................................#
#.....................#....................................#
#.....................#....................................#
#.....................#....................................#
#..........................................................#
#..........................................................#
#..........................................................#
#..........................................................#
#..........................................................#
#.....................#....................................#
#.....................#....................................#
#.....................#....................................#
#.....................#....................................#
#.....................#....................................#
#.....................#....................................#
#.....................#....................................#
#.....................#....................................#
#.....................#....................................#
#.....................#....................................#
#.....................#....................................#
############...######################.............##########
#.....................#....................................#
#.....................#....................................#
#.....................#....................................#
#.....................#....................................#
#.....................#....................................#
#.....................#....................................#
#.....................#....................................#
#.....................#....................................#
#.....................#....................................#
#.....................#....................................#
#.....................#....................................#
#.....................#....................................#
#..........................................................#
#..........................................................#
#..........................................................#
#..........................................................#
#..........................................................#
#..........................................................#
#..........................................................#
#..........................................................#
#.....................#....................................#
#.....................#....................................#
#.....................#....................................#
#.....................#....................................#
#.....................#....................................#
#.....................#....................................#
############################################################